Welcome to Haunted Church. Always ensure ethical decision-making for self-integrity.

HauntedChurch
An Interactive Fiction by Holly Best
Release 1 / Serial number 150220 / Inform 7 build 6L38 (I6/v6.33 lib 6/12N) SD

Office Building
It is another boring day at work. You hear the constant clicking sounds from employees around you. Phones ringing.

You can hear naughty sounds coming from Larry's computer next to your cubical.

You can also see a timesheet and a phone here.

>examine
What do you want to examine?

>computer
He's looking at porn!

>take
What do you want to take?

* * *

Welcome to Haunted Church. Always ensure ethical decision-making for self-integrity.

HauntedChurch
An Interactive Fiction by Holly Best
Release 1 / Serial number 150220 / Inform 7 build 6L38 (I6/v6.33 lib 6/12N) SD

Office Building
It is another boring day at work. You hear the constant clicking sounds from employees around you. Phones ringing.

You can hear naughty sounds coming from Larry's computer next to your cubical.

You can also see a timesheet and a phone here.

>df
That's not a verb I recognise.

>s
Boss's Office
You are in your Boss's office. He's not here.

* * *

Welcome to Haunted Church. Always ensure ethical decision-making for self-integrity.

HauntedChurch
An Interactive Fiction by Holly Best
Release 1 / Serial number 150220 / Inform 7 build 6L38 (I6/v6.33 lib 6/12N) SD

Office Building
It is another boring day at work. You hear the constant clicking sounds from employees around you. Phones ringing.

You can hear naughty sounds coming from Larry's computer next to your cubical.

You can also see a timesheet and a phone here.

>n
Foyer
Fuck this place. You walk to the foyer of the building to get out of here.

>w
Street
You peer through the window of the car and see YOUR MUM SUCKING OFF YOUR BOSS!

You can see the Car (empty) here.

>x car
The Car is empty.

>e
Foyer
Fuck this place. You walk to the foyer of the building to get out of here.

>w
Street
You peer through the window of the car and see YOUR MUM SUCKING OFF YOUR BOSS!

You can see the Car (empty) here.

* * *

>x car
The Car is empty.

>enter car
You can't see any such thing.

* * *

>w
Street
You peer through the window of the car and see YOUR MUM SUCKING OFF YOUR BOSS!

You can see the Car (empty) here.

>enter car
You get into the Car.

>drive e
That's not a verb I recognise.

>e
Foyer (in the Car)
Fuck this place. You walk to the foyer of the building to get out of here.

* * *

Welcome to Haunted Church. Always ensure ethical decision-making for self-integrity.

HauntedChurch
An Interactive Fiction by Holly Best
Release 1 / Serial number 150220 / Inform 7 build 6L38 (I6/v6.33 lib 6/12N) SD

Office Building
It is another boring day at work. You hear the constant clicking sounds from employees around you. Phones ringing.

You can hear naughty sounds coming from Larry's computer next to your cubical.

You can also see a timesheet and a phone here.

>ask Phoenix about drugs
Yeah man, I deal, but keep it on the downlow. If you want some, I don't have any on me, but I just sold The Boss a bag. He's trying to stiff me on the cash, so I'll let you in on a secret. He keeps the key to his desk in his "How To Be Succesful" book on his bookshelf.

>s
Boss's Office
You are in your Boss's office. He's not here.  I wonder what a guy like this keeps in his desk. 

You can see a drawer (closed) here.

>open drawer
It seems to be locked.

* * *

Welcome to Haunted Church. Always ensure ethical decision-making for self-integrity.

HauntedChurch
An Interactive Fiction by Holly Best
Release 1 / Serial number 150220 / Inform 7 build 6L38 (I6/v6.33 lib 6/12N) SD

Office Building
It is another boring day at work. You hear the constant clicking sounds from employees around you. Phones ringing.

You can hear naughty sounds coming from Larry's computer next to your cubical.

You can also see a timesheet and a phone here.

>examine phone
Man, has someone turned the default volume up on that phone? I wonder who's ringing?

>pick up phone
It's too heavy.

>examine computer
He's looking at porn!

* * *

Welcome to Haunted Church. Always ensure ethical decision-making for self-integrity.

HauntedChurch
An Interactive Fiction by Holly Best
Release 1 / Serial number 150220 / Inform 7 build 6L38 (I6/v6.33 lib 6/12N) SD

Office Building
It is another boring day at work. You hear the constant clicking sounds from employees around you. Phones ringing.

You can hear naughty sounds coming from Larry's computer next to your cubical.

You can also see a timesheet and a phone here.

>ask phoenix about drugs
What, man? I was too high on these DRUGS to hear you.

* * *

Welcome to Haunted Church. Always ensure ethical decision-making for self-integrity.

HauntedChurch
An Interactive Fiction by Holly Best
Release 1 / Serial number 150220 / Inform 7 build 6L38 (I6/v6.33 lib 6/12N) SD

Office Building
It is another boring day at work. You hear the constant clicking sounds from employees around you. Phones ringing.

You can hear naughty sounds coming from Larry's computer next to your cubical.

You can also see a timesheet and a phone here.

>s
Boss's Office
You are in your Boss's office. He's not here.  I wonder what a guy like this keeps in his desk. 

You can see a drawer (closed) and a boss's key here.

>open book
It isn't something you can open.

>x book
You see nothing special about the book.

* * *

>s
Boss's Office
You are in your Boss's office. He's not here.  I wonder what a guy like this keeps in his desk. 

You can see a drawer (closed) and a boss's key here.

>examine draw
You can't see any such thing.

>examine drawer
You see nothing special about the drawer.

Your boss walks in, fires you and calls the cops.

    *** You go to jail and get raped by Big Bob. ***

Would you like to RESTART, RESTORE a saved game, QUIT or UNDO the last command?

* * *

>s
Boss's Office
You are in your Boss's office. He's not here.  I wonder what a guy like this keeps in his desk. 

You can see a drawer (closed) and a boss's key here.

>open How To Be Succesful
It isn't something you can open.

* * *

>s
Boss's Office
You are in your Boss's office. He's not here.  I wonder what a guy like this keeps in his desk. 

You can see a drawer (closed) and a boss's key here.

>take key
Taken.

>unlock drawer with key
You unlock the drawer.

>take weed
You can't see any such thing.

>open drawer
You open the drawer, revealing some weed.

>take weed
Taken.

>i
You are carrying:
  some weed
  a key

* * *

>take key
Taken.

>unlcok drawer with key
That's not a verb I recognise.

>unlock drawer with key
You unlock the drawer.

>open drawer
You open the drawer.

>x drawer
You know it's the wrong thing to do but you look in the drawer anyway.

* * *

>s
Boss's Office
You are in your Boss's office. He's not here.  I wonder what a guy like this keeps in his desk. 

You can see a drawer (closed) and a boss's key here.

>take boss's key
Taken.

>unlock drawer with key
You unlock the drawer.

* * *

>s
Boss's Office
You are in your Boss's office. He's not here.  I wonder what a guy like this keeps in his desk. 

You can see a drawer (closed) and a boss's key here.

>e
You can't go that way.

>ex
That's not a verb I recognise.

* * *

>s
Boss's Office
You are in your Boss's office. He's not here.  I wonder what a guy like this keeps in his desk. 

You can see a drawer (closed) and a boss's key here.

>n
Office Building
It is another boring day at work. You hear the constant clicking sounds from employees around you. Phones ringing.

You can hear naughty sounds coming from Larry's computer next to your cubical.

You can also see a timesheet and a phone here.

>w
You can't go that way.

>e
You can't go that way.

>n
Foyer
Fuck this place. You walk to the foyer of the building to get out of here.

* * *

>s
Boss's Office
You are in your Boss's office. He's not here.  I wonder what a guy like this keeps in his desk. 

You can see a drawer (closed) and a boss's key here.

>examine drawer
Damn! It's locked.

>n
Office Building
It is another boring day at work. You hear the constant clicking sounds from employees around you. Phones ringing.

You can hear naughty sounds coming from Larry's computer next to your cubical.

You can also see a phone here.

>s
Boss's Office
You are in your Boss's office. He's not here. 

You can see a drawer here.

* * *

>s
Boss's Office
You are in your Boss's office. He's not here.  I wonder what a guy like this keeps in his desk. 

You can see a drawer (closed) and a boss's key here.

>x bookshelf
The bookshelf is empty.

>open How To Be Successful
I only understood you as far as wanting to open the book How To Be Succesful.

>examine How To Be Successful
I only understood you as far as wanting to examine the book How To Be Succesful.

* * *

Welcome to Haunted Church. Always ensure ethical decision-making for self-integrity.

HauntedChurch
An Interactive Fiction by Holly Best
Release 1 / Serial number 150220 / Inform 7 build 6L38 (I6/v6.33 lib 6/12N) SD

Office Building
It is another boring day at work. You hear the constant clicking sounds from employees around you. Phones ringing.

You can hear naughty sounds coming from Larry's computer next to your cubical.

You can also see a timesheet and a phone here.

>x phoenix
Phoenix is a cool motherfucker. Like, he could easilly get your mum to ACTUALLY fuck him. He always comes in late, but the boss never seems to fire him.

>ask phoenix about chickens
What, man? I was too high on these DRUGS to hear you.

* * *

>x phoenix
Phoenix is a cool motherfucker. Like, he could easilly get your mum to ACTUALLY fuck him. He always comes in late, but the boss never seems to fire him.

>ask phoenix about drugs
Drugs!

>talk to phoenix
That's not a verb I recognise.

* * *

Welcome to Haunted Church. Always ensure ethical decision-making for self-integrity.

HauntedChurch
An Interactive Fiction by Holly Best
Release 1 / Serial number 150220 / Inform 7 build 6L38 (I6/v6.33 lib 6/12N) SD

Office Building
It is another boring day at work. You hear the constant clicking sounds from employees around you. Phones ringing.

You can hear naughty sounds coming from Larry's computer next to your cubical.

You can also see a timesheet and a phone here.

>ask phoenix about chicken
You can't see any such thing.

>x phoenix
You can't see any such thing.

>x phoenix
You can't see any such thing.

* * *

Welcome to Haunted Church. Always ensure ethical decision-making for self-integrity.

HauntedChurch
An Interactive Fiction by Holly Best
Release 1 / Serial number 150220 / Inform 7 build 6L38 (I6/v6.33 lib 6/12N) SD

Office Building
It is another boring day at work. You hear the constant clicking sounds from employees around you. Phones ringing.

You can hear naughty sounds coming from Larry's computer next to your cubical.

You can also see a timesheet and a phone here.

>ask phoenix about weed
Drugs!

* * *

Welcome to Haunted Church. Always ensure ethical decision-making for self-integrity.

HauntedChurch
An Interactive Fiction by Holly Best
Release 1 / Serial number 150220 / Inform 7 build 6L38 (I6/v6.33 lib 6/12N) SD

Office Building
It is another boring day at work. You hear the constant clicking sounds from employees around you. Phones ringing.

You can hear naughty sounds coming from Larry's computer next to your cubical.

You can also see a timesheet and a phone here.

>pick up
What do you want to pick up?

>phone
It's too heavy.